
SELECT TABLE_NAME as 'Название таблицы',COLUMN_NAME as 'Название первичного ключа' FROM `KEY_COLUMN_USAGE` WHERE TABLE_SCHEMA = 'sakila' and CONSTRAINT_NAME = 'primary';


Название таблицы	Название первичного ключа	
actor	actor_id	
address	address_id	
category	category_id	
city	city_id	
country	country_id	
customer	customer_id	
film	film_id	
film_actor	actor_id	
film_actor	film_id	
film_category	film_id	
film_category	category_id	
film_text	film_id	
inventory	inventory_id	
language	language_id	
payment	payment_id	
rental	rental_id	
staff	staff_id	
store	store_id	

